{
  "<blank>": 0,
  "<unk>": 1,
  "ty": 2,
  "dy": 3,
  "v": 4,
  "py": 5,
  "my": 6,
  "by": 7,
  "ny": 8,
  "hy": 9,
  "gy": 10,
  "ry": 11,
  "ky": 12,
  "f": 13,
  "p": 14,
  "z": 15,
  "ch": 16,
  "ts": 17,
  "j": 18,
  "b": 19,
  "y": 20,
  "h": 21,
  "cl": 22,
  "I": 23,
  "U": 24,
  "w": 25,
  "g": 26,
  "d": 27,
  "sh": 28,
  "pau": 29,
  "m": 30,
  "N": 31,
  "s": 32,
  "r": 33,
  "t": 34,
  "n": 35,
  "k": 36,
  "e": 37,
  "u": 38,
  "i": 39,
  "o": 40,
  "a": 41,
  "<sos/eos>": 42
}